v v v v v v v v v v v v v v v v v v v v v v v v v v v v v v v v v v v v v v v v 
v v v v v v v v v v v v v v v v v v v v v v v v v v v v v v v v v v v v v v v v 
v v v v v v v v v v v v v v v v v v v v v v v v v v v v v v v v v v v v v v v v 
v v v v v v v v v v v v v v v v v v v v v v v v v v v v v v v v v v v v v v v v 
v v v v v v v v v v v v v v v v v v v v v v v v v v v v v v v v v v v v v v v v 
v v v v v v v v v v v v v v v v v v v v v v v v v v v v v v v v v v v v v v v v 
v v v v v v v v v v v v v v v w w w w w w v v w w w w w v v v v v v v v v v v v 
v v v v v v v v v v v v v v v w h f f f w w w w f f f w w v v v v v v v v v v v 
v v v v v v v v v v v v v v v w w w w f w w f f f b f d w v v v v v v v v v v v 
v v v v v v v v v v v v v v v v v v w f w w e w f f f w w v v v v v v v v v v v 
v v v v v v v v v v v v v v v v v v w f e f f w w w w w w w v v v v v v v v v v 
v v v v v v v v v v v v v v v v v v w f w w f w w w w w h w v v v v v v v v v v 
v v v v v v v v v v v v v v v w w w w e w w e w f f f w f w v v v v v v v v v v 
v v v v v v v v v v v v v v v w f p f f w w f f f b f f f w v v v v v v v v v v 
v v v v v v v v v v v v v v v w w w w w w w w w f f f w w w v v v v v v v v v v 
v v v v v v v v v v v v v v v v v v v v v v v w w w w w v v v v v v v v v v v v 
v v v v v v v v v v v v v v v v v v v v v v v v v v v v v v v v v v v v v v v v 
v v v v v v v v v v v v v v v v v v v v v v v v v v v v v v v v v v v v v v v v 
v v v v v v v v v v v v v v v v v v v v v v v v v v v v v v v v v v v v v v v v 
v v v v v v v v v v v v v v v v v v v v v v v v v v v v v v v v v v v v v v v v 
v v v v v v v v v v v v v v v v v v v v v v v v v v v v v v v v v v v v v v v v 
v v v v v v v v v v v v v v v v v v v v v v v v v v v v v v v v v v v v v v v v 
100