v v v v v v v v v v v v v v v v v v v v v v v v v v v v v v v v v v v v v v v v 
v v v v v v v v v v v v v v v v v v v v v v v v v v v v v v v v v v v v v v v v 
v v v v v v v v v v v v v v v v v v v v v v v v v v v v v v v v v v v v v v v v 
v v v v v v v v v v v v v v v v v v v v v v v v v v v v v v v v v v v v v v v v 
v v v v v v v v v v v v v v v v v v v v v v v w w w w w v v v v v v v v v v v v 
v v v v v v v v v v v v v v v v v v w w w w w w f f f w v v v v v v v v v v v v 
v v v v v v v v v v v v v v v v v v w f f f f f f b f w v v v v v v v v v v v v 
v v v v v v v v v v v v v v v v v v w f w w w w f f f w v v v v v v v v v v v v 
v v v v v v v v v v v v v v v v v v w f w v v w w h w w v v v v v v v v v v v v 
v v v v v v v v v v v w w w w w w w w f w w w w f f f w v v v v v v v v v v v v 
v v v v v v v v v v v w d p f f f f f f f f f f f b f w v v v v v v v v v v v v 
v v v v v v v v v v v w w w w w w w w f w w w w f f f w v v v v v v v v v v v v 
v v v v v v v v v v v v v v v v v v w f w v v w w e w w v v v v v v v v v v v v 
v v v v v v v v v v v v v v v v v v w f w w w w f f f w v v v v v v v v v v v v 
v v v v v v v v v v v v v v v v v v w f f f f f f b f w v v v v v v v v v v v v 
v v v v v v v v v v v v v v v v v v w w w w w w f f f w v v v v v v v v v v v v 
v v v v v v v v v v v v v v v v v v v v v v v w w w w w v v v v v v v v v v v v 
v v v v v v v v v v v v v v v v v v v v v v v v v v v v v v v v v v v v v v v v 
v v v v v v v v v v v v v v v v v v v v v v v v v v v v v v v v v v v v v v v v 
v v v v v v v v v v v v v v v v v v v v v v v v v v v v v v v v v v v v v v v v 
v v v v v v v v v v v v v v v v v v v v v v v v v v v v v v v v v v v v v v v v 
v v v v v v v v v v v v v v v v v v v v v v v v v v v v v v v v v v v v v v v v 
56