v v v v v v v v v v v v v v v v v v v v v v v v v v v v v v v v v v v v v v v v 
v v v v v v v v v v v v v v v v v v v v v v v v v v v v v v v v v v v v v v v v 
v v v v v v v v v v v w w w w w w w w w w w w w w w w w v v v v v v v v v v v v 
v v v v v v v v v v v w h f f f f f f p f f f f f f h w v v v v v v v v v v v v 
v v v v v v v v v v v w f w w w w w w f w w w w w w f w v v v v v v v v v v v v 
v v v v v v v v v v v w f w w w w w w f w w w w w w f w v v v v v v v v v v v v 
v v v v v v v v v v v w f w w w w w w e w w w w w w f w v v v v v v v v v v v v 
v v v v v v v v v v v w f w w w w w w w w w w w w w f w v v v v v v v v v v v v 
v v v v v v v v v v v w f w w w w w w d w w w w w w f w v v v v v v v v v v v v 
v v v v v v v v v v v w f w w w w w f f f w w w w w f w v v v v v v v v v v v v 
v v v v v v v v v v v w f f f h f f f b f f f h f f f w v v v v v v v v v v v v 
v v v v v v v v v v v w f w w f w w f f f w w f w w f w v v v v v v v v v v v v 
v v v v v v v v v v v w f w w f w w w f w w w f w w f w v v v v v v v v v v v v 
v v v v v v v v v v v w f w w f w w w f w w w f w w f w v v v v v v v v v v v v 
v v v v v v v v v v v w f w w e f f f h f f f e w w f w v v v v v v v v v v v v 
v v v v v v v v v v v w f w w w w w w f w w w w w w f w v v v v v v v v v v v v 
v v v v v v v v v v v w f w w w w w w f w w w w w w f w v v v v v v v v v v v v 
v v v v v v v v v v v w e f f f f f f f f f f f f f e w v v v v v v v v v v v v 
v v v v v v v v v v v w w w w w w w w w w w w w w w w w v v v v v v v v v v v v 
v v v v v v v v v v v v v v v v v v v v v v v v v v v v v v v v v v v v v v v v 
v v v v v v v v v v v v v v v v v v v v v v v v v v v v v v v v v v v v v v v v 
v v v v v v v v v v v v v v v v v v v v v v v v v v v v v v v v v v v v v v v v 
42