v v v v v v v v v v v v v v v v v v v v v v v v v v v v v v v v v v v v v v v v 
v v v v v v v v v v v v v v v v v v v v v v v v v v v v v v v v v v v v v v v v 
v v v v v v v v v v v v v v v v v v v v v v v v v v v v v v v v v v v v v v v v 
v v v v v v v v v v v v v v v v v v v v v v v v v v v v v v v v v v v v v v v v 
v v v v v v v v v v v v v v v v v v v v v v v v v v v v v v v v v v v v v v v v 
v v v v v v v v v v v v v v v v v v v v v v v v v v v v v v v v v v v v v v v v 
v v v v v v v v v v v v v v v v v v w w w w w w w v v v v v v v v v v v v v v v 
v v v v v v v v v v w w w w w w w w w f f h f f w v v v v v v v v v v v v v v v 
v v v v v v v v v v w f f e f h f w w f w w w f w w v v v v v v v v v v v v v v 
v v v v v v v v v w w f w w w w f w f f f w f f f w v v v v v v v v v v v v v v 
v v v v v v v v v w p f f f f f e f f b f f f b f w v v v v v v v v v v v v v v 
v v v v v v v v v w w w w w w w w w f f f w f f f w v v v v v v v v v v v v v v 
v v v v v v v v v v v v v v v v v w w d w w w h w w v v v v v v v v v v v v v v 
v v v v v v v v v v v v v v v v v v w w w w w w w v v v v v v v v v v v v v v v 
v v v v v v v v v v v v v v v v v v v v v v v v v v v v v v v v v v v v v v v v 
v v v v v v v v v v v v v v v v v v v v v v v v v v v v v v v v v v v v v v v v 
v v v v v v v v v v v v v v v v v v v v v v v v v v v v v v v v v v v v v v v v 
v v v v v v v v v v v v v v v v v v v v v v v v v v v v v v v v v v v v v v v v 
v v v v v v v v v v v v v v v v v v v v v v v v v v v v v v v v v v v v v v v v 
v v v v v v v v v v v v v v v v v v v v v v v v v v v v v v v v v v v v v v v v 
v v v v v v v v v v v v v v v v v v v v v v v v v v v v v v v v v v v v v v v v 
v v v v v v v v v v v v v v v v v v v v v v v v v v v v v v v v v v v v v v v v 
11