v v v v v v v v v v v v v v v v v v v v v v v v v v v v v v v v v v v v v v v v 
v v v v v v v v v v v v v v v v v v v v v v v v v v v v v v v v v v v v v v v v 
v v v v v v v v v v v v v v v v v v v v v v v v v v v v v v v v v v v v v v v v 
v v v v v v v v v v v v v v v v v v v v v v v v v v v v v v v v v v v v v v v v 
v v v v v v v v v v v v v v v v v v v v v v v v v v v v v v v v v v v v v v v v 
v v v v v v v v v v v v v v v w w w w w w w v v v v v v v v v v v v v v v v v v 
v v v v v v v v v v v v v v v w f f e f f w w w w v v v v v v v v v v v v v v v 
v v v v v v v v v v v v v w w w f w w w f f f h w v v v v v v v v v v v v v v v 
v v v v v v v v v v v v v w h f f w w w f w w f w v v v v v v v v v v v v v v v 
v v v v v v v v v v v v v w f w f w w w f w w f w w w w w v v v v v v v v v v v 
v v v v v v v v v v v v v w f w f f e f f f w f w f f f w w v v v v v v v v v v 
v v v v v v v v v v v v v w f w w w f w w f f f f f b f d w v v v v v v v v v v 
v v v v v v v v v v v v v w p f f f f w w f w w w f f f w w v v v v v v v v v v 
v v v v v v v v v v v v v w w w w w f f f e w w w w w w w v v v v v v v v v v v 
v v v v v v v v v v v v v v v v v w w w w w w v v v v v v v v v v v v v v v v v 
v v v v v v v v v v v v v v v v v v v v v v v v v v v v v v v v v v v v v v v v 
v v v v v v v v v v v v v v v v v v v v v v v v v v v v v v v v v v v v v v v v 
v v v v v v v v v v v v v v v v v v v v v v v v v v v v v v v v v v v v v v v v 
v v v v v v v v v v v v v v v v v v v v v v v v v v v v v v v v v v v v v v v v 
v v v v v v v v v v v v v v v v v v v v v v v v v v v v v v v v v v v v v v v v 
v v v v v v v v v v v v v v v v v v v v v v v v v v v v v v v v v v v v v v v v 
v v v v v v v v v v v v v v v v v v v v v v v v v v v v v v v v v v v v v v v v 
30