v v v v v v v v v v v v v v v v v v v v v v v v v v v v v v v v v v v v v v v v 
v v v v v v v v v v v v v v v v v v v v v v v v v v v v v v v v v v v v v v v v 
v v v v v v v v v v v v v v v v v v v v v v v v v v v v v v v v v v v v v v v v 
v v v v v v v v v v v v v v v v v v v v v v v v v v v v v v v v v v v v v v v v 
v v v v v v v v v v v v v v v v v v v v v v v v v v v v v v v v v v v v v v v v 
v v v v v v v v v v v v v v v v v v v v v v v v v v v v v v v v v v v v v v v v 
v v v v v v v v v v v v v v v v v v v w w w v v v v v v v v v v v v v v v v v v 
v v v v v v v v v v v v v v v w w w w w h w w w w w v v v v v v v v v v v v v v 
v v v v v v v v v v v v v w w w f f f w f w f f f w v v v v v v v v v v v v v v 
v v v v v v v v v v v v v w h f f b f f f f f b f w v v v v v v v v v v v v v v 
v v v v v v v v v v v v v w w w f f f w f w f f f w v v v v v v v v v v v v v v 
v v v v v v v v v v v v v v v v w w w w f w w e w w v v v v v v v v v v v v v v 
v v v v v v v v v v v v v v v v w p f f f f f f w v v v v v v v v v v v v v v v 
v v v v v v v v v v v v v v v v w w w w w w w f w v v v v v v v v v v v v v v v 
v v v v v v v v v v v v v v v v v v v v v v w d w v v v v v v v v v v v v v v v 
v v v v v v v v v v v v v v v v v v v v v v w w w v v v v v v v v v v v v v v v 
v v v v v v v v v v v v v v v v v v v v v v v v v v v v v v v v v v v v v v v v 
v v v v v v v v v v v v v v v v v v v v v v v v v v v v v v v v v v v v v v v v 
v v v v v v v v v v v v v v v v v v v v v v v v v v v v v v v v v v v v v v v v 
v v v v v v v v v v v v v v v v v v v v v v v v v v v v v v v v v v v v v v v v 
v v v v v v v v v v v v v v v v v v v v v v v v v v v v v v v v v v v v v v v v 
v v v v v v v v v v v v v v v v v v v v v v v v v v v v v v v v v v v v v v v v 
26