v v v v v v v v v v v v v v v v v v v v v v v v v v v v v v v v v v v v v v v v 
v v v v v v v v v v v v v v v v v v v v v v v v v v v v v v v v v v v v v v v v 
v v v v v v v v v v v v v v v v v v v v v v v v v w w w w w v v v v v v v v v v 
v v v v v v v v v v v v v v v v v v v v v v w w w w f f f w v v v v v v v v v v 
v v v v v v v v v v v v v v v v v v v v v v w e f f f b f w v v v v v v v v v v 
v v v v v v v v v v v v v v v v v v v v v v w f w w f f f w v v v v v v v v v v 
v v v v v v v v v v v v v v v v v v v v v v w f w w w f w w v v v v v v v v v v 
v v v v v v v v v v v v v v v v v w w w w w w f w v w e w v v v v v v v v v v v 
v v v v v v v v v v v v v v v v v w f f f f f f w w w f w w v v v v v v v v v v 
v v v v v v v v v v v v v v v w w w f w w w w w w w f f f w w v v v v v v v v v 
v v v v v v v v v v v v v v v w p f f f f f f f f f f b f d w v v v v v v v v v 
v v v v v v v v v v v v v v v w w w f w w w w f w w f f f w w v v v v v v v v v 
v v v v v v v v v v v v v v v v v w f f f e f f w w w h w w v v v v v v v v v v 
v v v v v v v v v v v v v v v v v w w w w w w w w v w w w v v v v v v v v v v v 
v v v v v v v v v v v v v v v v v v v v v v v v v v v v v v v v v v v v v v v v 
v v v v v v v v v v v v v v v v v v v v v v v v v v v v v v v v v v v v v v v v 
v v v v v v v v v v v v v v v v v v v v v v v v v v v v v v v v v v v v v v v v 
v v v v v v v v v v v v v v v v v v v v v v v v v v v v v v v v v v v v v v v v 
v v v v v v v v v v v v v v v v v v v v v v v v v v v v v v v v v v v v v v v v 
v v v v v v v v v v v v v v v v v v v v v v v v v v v v v v v v v v v v v v v v 
v v v v v v v v v v v v v v v v v v v v v v v v v v v v v v v v v v v v v v v v 
v v v v v v v v v v v v v v v v v v v v v v v v v v v v v v v v v v v v v v v v 
57