v v v v v v v v v v v v v v v v v v v v v v v v v v v v v v v v v v v v v v v v 
v v v v v v v v v v v v v v v v v v v v v v v v v v v v v v v v v v v v v v v v 
v v v v v v v v v v v v v v v v v v v v v v v v v v v v v v v v v v v v v v v v 
v v v v v v v v v v v v v v v v w w w v v v v v v v v v v v v v v v v v v v v v 
v v v v v v v v v v v v v v v v w h w v v v v v v v v v v v v v v v v v v v v v 
v v v v v v v v v v v v v v v v w f w v v v v v v v v v v v v v v v v v v v v v 
v v v v v v v v v v v v v v v v w e w w w w w v v v v v v v v v v v v v v v v v 
v v v v v v v v v v v v v v v v w f f f f e w v v v v v v v v v v v v v v v v v 
v v v v v v v v v v w w w w w w w f w w w f w w v v v v v v v v v v v v v v v v 
v v v v v v v v v v w h f f w w w f w w f f f w w v v v v v v v v v v v v v v v 
v v v v v v v v v v w w w f e f f f f f f b f d w v v v v v v v v v v v v v v v 
v v v v v v v v v w w w w f w w w w w w f f f w w v v v v v v v v v v v v v v v 
v v v v v v v v v w h f e f w v v v v w w f w w v v v v v v v v v v v v v v v v 
v v v v v v v v v w w w w f w v v v v v w h w v v v v v v v v v v v v v v v v v 
v v v v v v v v v v w w w f w v v v v v w w w v v v v v v v v v v v v v v v v v 
v v v v v v v v v v w w w f w v v v v v v v v v v v v v v v v v v v v v v v v v 
v v v v v v v v v v w p f f w v v v v v v v v v v v v v v v v v v v v v v v v v 
v v v v v v v v v v w w w w w v v v v v v v v v v v v v v v v v v v v v v v v v 
v v v v v v v v v v v v v v v v v v v v v v v v v v v v v v v v v v v v v v v v 
v v v v v v v v v v v v v v v v v v v v v v v v v v v v v v v v v v v v v v v v 
v v v v v v v v v v v v v v v v v v v v v v v v v v v v v v v v v v v v v v v v 
v v v v v v v v v v v v v v v v v v v v v v v v v v v v v v v v v v v v v v v v 
13