v v v v v v v v v v v v v v v v v v v v v v v v v v v v v v v v v v v v v v v v 
v v v v v v v v v v v v v v v v v v v v v v v v v v v v v v v v v v v v v v v v 
v v v v v v v v v v v v v v v v v v v v v v v v v v v v v v v v v v v v v v v v 
v v v v v v v v v v v v w w w w w w w w w v v v v v v v v v v v v v v v v v v v 
v v v v v v v v v v v v w e f f f f f f w v v v v v v v v v v v v v v v v v v v 
v v v v v v v v v v v w w f w w w w w h w w w v v v v v v v v v v v v v v v v v 
v v v v v v v v v v v w f f f w w f f f f f w v v v v v v v v v v v v v v v v v 
v v v v v v v v v v v w f b f f f f w w w e w v v v v v v v v v v v v v v v v v 
v v v v v v v v v v v w f f f w w f w w w f w v v v v v v v v v v v v v v v v v 
v v v v v v v v v v v w w d w w w f w w w f w v v v v v v v v v v v v v v v v v 
v v v v v v v v v v v v w w w w w f w w w f w v v v v v v v v v v v v v v v v v 
v v v v v v v v v v v v v v v v w f e f f h w v v v v v v v v v v v v v v v v v 
v v v v v v v v v v v v v v v v w w w f w w w v v v v v v v v v v v v v v v v v 
v v v v v v v v v v v v v v v v v v w p w v v v v v v v v v v v v v v v v v v v 
v v v v v v v v v v v v v v v v v v w w w v v v v v v v v v v v v v v v v v v v 
v v v v v v v v v v v v v v v v v v v v v v v v v v v v v v v v v v v v v v v v 
v v v v v v v v v v v v v v v v v v v v v v v v v v v v v v v v v v v v v v v v 
v v v v v v v v v v v v v v v v v v v v v v v v v v v v v v v v v v v v v v v v 
v v v v v v v v v v v v v v v v v v v v v v v v v v v v v v v v v v v v v v v v 
v v v v v v v v v v v v v v v v v v v v v v v v v v v v v v v v v v v v v v v v 
v v v v v v v v v v v v v v v v v v v v v v v v v v v v v v v v v v v v v v v v 
v v v v v v v v v v v v v v v v v v v v v v v v v v v v v v v v v v v v v v v v 
15