v v v v v v v v v v v v v v v v v v v v v v v v v v v v v v v v v v v v v v v v 
v v v v v v v v v v v v v v v v v v v v v v v v v v v v v v v v v v v v v v v v 
v v v v v v v v v v v v v v v v v v v v v v v v v v v v v v v v v v v v v v v v 
v v v v v v v v v v v v v v v v v v v v v v v v v v v v v v v v v v v v v v v v 
v v v v v v v v v v v v v v v v w w w w w w w w v v v v v v v v v v v v v v v v 
v v v v v v v v v v v v v v v v w e f f f f h w v v v v v v v v v v v v v v v v 
v v v v v v v v v v v v v v v v w f w w w w f w v v v v v v v v v v v v v v v v 
v v v v v v v v v v v v v v v v w f w w w w e w w w v v v v v v v v v v v v v v 
v v v v v v v v v v v v v v v v w f f h w w f f f w v v v v v v v v v v v v v v 
v v v v v v v v v v v v v v v v w w w f w w w w f w w v v v v v v v v v v v v v 
v v v v v v v v v v v v v v w w w w w f w w w f f f w w v v v v v v v v v v v v 
v v v v v v v v v v v v v v w p f f f f f f f f b f d w v v v v v v v v v v v v 
v v v v v v v v v v v v v v w w w w w f w w w f f f w w v v v v v v v v v v v v 
v v v v v v v v v v v v v v v w w w w f w w w w e w w v v v v v v v v v v v v v 
v v v v v v v v v v v v v v v w h f f f f f f f f w v v v v v v v v v v v v v v 
v v v v v v v v v v v v v v v w w w w w w w w w w w v v v v v v v v v v v v v v 
v v v v v v v v v v v v v v v v v v v v v v v v v v v v v v v v v v v v v v v v 
v v v v v v v v v v v v v v v v v v v v v v v v v v v v v v v v v v v v v v v v 
v v v v v v v v v v v v v v v v v v v v v v v v v v v v v v v v v v v v v v v v 
v v v v v v v v v v v v v v v v v v v v v v v v v v v v v v v v v v v v v v v v 
v v v v v v v v v v v v v v v v v v v v v v v v v v v v v v v v v v v v v v v v 
v v v v v v v v v v v v v v v v v v v v v v v v v v v v v v v v v v v v v v v v 
22