v v v v v v v v v v v v v v v v v v v v v v v v v v v v v v v v v v v v v v v v 
v v v v v v v v v v v v v v v v v v v v v v v v v v v v v v v v v v v v v v v v 
v v v v v v v v v v v v v v v v v v v v v v v v v v v v v v v v v v v v v v v v 
v v v v v v v v v v v v v v v v v v v v v v v v v v v v v v v v v v v v v v v v 
v v v v v v v v v v v v v v v v v v v v v v v v v v v v v v v v v v v v v v v v 
v v v v v v v v v v v v v v v v w w w v v v v v v v v v v v v v v v v v v v v v 
v v v v v v v v v v v v v v v v w p w v v v v v v v v v v v v v v v v v v v v v 
v v v v v v v v v v v v v v v v w f w w w w w w w v v v v v v v v v v v v v v v 
v v v v v v v v v v v v v v v v w f w w w h f e w v v v v v v v v v v v v v v v 
v v v v v v v v v v v v v w w w w f w w w f w f w v v v v v v v v v v v v v v v 
v v v v v v v v v v v v v w e f f f f f f f w f w w w w w w v v v v v v v v v v 
v v v v v v v v v v v v v w f w w f w w w w w f w w f f f w w v v v v v v v v v 
v v v v v v v v v v v v v w f w w f f f w w h f f f f b f d w v v v v v v v v v 
v v v v v v v v v v v v v w h f f e w f w w f w w w f f f w w v v v v v v v v v 
v v v v v v v v v v v v v w w w w w w f f f f w w w w w w w v v v v v v v v v v 
v v v v v v v v v v v v v v v v v v w w w w w w v v v v v v v v v v v v v v v v 
v v v v v v v v v v v v v v v v v v v v v v v v v v v v v v v v v v v v v v v v 
v v v v v v v v v v v v v v v v v v v v v v v v v v v v v v v v v v v v v v v v 
v v v v v v v v v v v v v v v v v v v v v v v v v v v v v v v v v v v v v v v v 
v v v v v v v v v v v v v v v v v v v v v v v v v v v v v v v v v v v v v v v v 
v v v v v v v v v v v v v v v v v v v v v v v v v v v v v v v v v v v v v v v v 
v v v v v v v v v v v v v v v v v v v v v v v v v v v v v v v v v v v v v v v v 
14