v v v v v v v v v v v v v v v v v v v v v v v v v v v v v v v v v v v v v v v v 
v v v v v v v v v v v v v v v v v v v v v v v v v v v v v v v v v v v v v v v v 
v v v v v v v v v v v v v v v v v v v v v v v v v v v v v v v v v v v v v v v v 
v v v v v v v v v v v v v v v v v v v v v v v v v v v v v v v v v v v v v v v v 
v v v v v v v v v v v v v v v v v v v v v v v v v v v v v v v v v v v v v v v v 
v v v v v v v v v v v v v v v v v v v v v v v v v v v v v v v v v v v v v v v v 
v v v v v v v v v v v v v v v v v v v v v v v v v v v v v v v v v v v v v v v v 
v v v v v v v v v v f f f f f f f f f f f f f f f f f f f v v v v v v v v v v v 
v v v v v v v v v v h v v h v v h v v v v v h v v h v v h v v v v v v v v v v v 
v v v v v v v v v f f f v f v v f v v v v v f v v f v f f f v v v v v v v v v v 
v v v v v v v v v f b f f e f f e f f p f f e f f e f f b f v v v v v v v v v v 
v v v v v v v v v f f f v v v v v v v f v v v v v v v f f f v v v v v v v v v v 
v v v v v v v v v v v v v v v v v v v d v v v v v v v v v v v v v v v v v v v v 
v v v v v v v v v v v v v v v v v v v v v v v v v v v v v v v v v v v v v v v v 
v v v v v v v v v v v v v v v v v v v v v v v v v v v v v v v v v v v v v v v v 
v v v v v v v v v v v v v v v v v v v v v v v v v v v v v v v v v v v v v v v v 
v v v v v v v v v v v v v v v v v v v v v v v v v v v v v v v v v v v v v v v v 
v v v v v v v v v v v v v v v v v v v v v v v v v v v v v v v v v v v v v v v v 
v v v v v v v v v v v v v v v v v v v v v v v v v v v v v v v v v v v v v v v v 
v v v v v v v v v v v v v v v v v v v v v v v v v v v v v v v v v v v v v v v v 
v v v v v v v v v v v v v v v v v v v v v v v v v v v v v v v v v v v v v v v v 
v v v v v v v v v v v v v v v v v v v v v v v v v v v v v v v v v v v v v v v v 
30