v v v v v v v v v v v v v v v v v v v v v v v v v v v v v v v v v v v v v v v v 
v v v v v v v v v v v v v v v v v v v v v v v v v v v v v v v v v v v v v v v v 
v v v v v v v v v v v v v v v v v v v v v v v v v v v v v v v v v v v v v v v v 
v v v v v v v v v v v v v v v v v v v v v v v v v v v v v v v v v v v v v v v v 
v v v v v v v v v v v v v v v v v v v v v v v v v v v v v v v v v v v v v v v v 
v v v v v v v v v v v v v v v v v v v v v v v v v v v v v v v v v v v v v v v v 
v v v v v v v v v v v v v v v v v v v v v v v v v v v v v v v v v v v v v v v v 
v v v v v v v v v w w w w w w w w w w w w w w w w w w w w w v v v v v v v v v v 
v v v v v v v v v w f f f f f f f f f f f f f f f f f f f w v v v v v v v v v v 
v v v v v v v v w w h w w h w w h w w w w w h w w h w w h w w v v v v v v v v v 
v v v v v v v v w f f f w f w w f w w w w w f w w f w f f f w v v v v v v v v v 
v v v v v v v v w f b f f e f f e f f p f f e f f e f f b f w v v v v v v v v v 
v v v v v v v v w f f f w w w w w w w f w w w w w w w f f f w v v v v v v v v v 
v v v v v v v v w w w w w v v v v v w d w v v v v v w w w w w v v v v v v v v v 
v v v v v v v v v v v v v v v v v v w w w v v v v v v v v v v v v v v v v v v v 
v v v v v v v v v v v v v v v v v v v v v v v v v v v v v v v v v v v v v v v v 
v v v v v v v v v v v v v v v v v v v v v v v v v v v v v v v v v v v v v v v v 
v v v v v v v v v v v v v v v v v v v v v v v v v v v v v v v v v v v v v v v v 
v v v v v v v v v v v v v v v v v v v v v v v v v v v v v v v v v v v v v v v v 
v v v v v v v v v v v v v v v v v v v v v v v v v v v v v v v v v v v v v v v v 
v v v v v v v v v v v v v v v v v v v v v v v v v v v v v v v v v v v v v v v v 
v v v v v v v v v v v v v v v v v v v v v v v v v v v v v v v v v v v v v v v v 
30