v v v v v v v v v v v v v v v v v v v v v v v v v v v v v v v v v v v v v v v v 
v v v v v v v v v v v v v v v v v v v v v v v v v v v v v v v v v v v v v v v v 
v v v v v v v v v v v f f f f f f f f f f f f f v v v v v v v v v v v v v v v v 
v v v v v v v v v v v f v h v v v v v v v v v f v v v v v v v v v v v v v v v v 
v v v v v v v v v v v f v f v v v f f f f f v f v v v v v v v v v v v v v v v v 
v v v v v v v v v v v f v f v v v f v v v f v f v v v v v v v v v v v v v v v v 
v v v v v v v v v v v f v f v f f f f f v f v f v v v v v v v v v v v v v v v v 
v v v v v v v v v v v f v f v f v v v f v e v f v v v v v v v v v v v v v v v v 
v v v v v v v v v v v f v f v f f f v f v v v f v v v v v v v v v v v v v v v v 
v v v v v v v v v v v f v f v f v f v f v f h f v v v v v f f f v v v v v v v v 
v v v v v v v v v v v f v f f f v f v p v f v f v v v f f f b f d v v v v v v v 
v v v v v v v v v v v f v v v f v f v v v f v f v v v f v f f f v v v v v v v v 
v v v v v v v v v v v f v f f f v f f f f f v f v v v f v v v v v v v v v v v v 
v v v v v v v v v v v f v f v f v v v v v v v f v v v f v v v v v v v v v v v v 
v v v v v v v v v v v f v f v f f f f f f f f f v v v f v v v v v v v v v v v v 
v v v v v v v v v v v f v f v v v v v v v f v v v v v f v v v v v v v v v v v v 
v v v v v v v v v v v f v e f f f f f h v f f f f e f f v v v v v v v v v v v v 
v v v v v v v v v v v f v v v v v v v f v v v v v v v f v v v v v v v v v v v v 
v v v v v v v v v v v f f f f f f f f f f f f f f f f f v v v v v v v v v v v v 
v v v v v v v v v v v v v v v v v v v v v v v v v v v v v v v v v v v v v v v v 
v v v v v v v v v v v v v v v v v v v v v v v v v v v v v v v v v v v v v v v v 
v v v v v v v v v v v v v v v v v v v v v v v v v v v v v v v v v v v v v v v v 
76