v v v v v v v v v v v v v v v v v v v v v v v v v v v v v v v v v v v v v v v v 
v v v v v v v v v v w w w w w w w w w w w w w w w v v v v v v v v v v v v v v v 
v v v v v v v v v v w f f f f f f f f f f f f f w v v v v v v v v v v v v v v v 
v v v v v v v v v v w f w h w w w w w w w w w f w v v v v v v v v v v v v v v v 
v v v v v v v v v v w f w f w w w f f f f f w f w v v v v v v v v v v v v v v v 
v v v v v v v v v v w f w f w w w f w w w f w f w v v v v v v v v v v v v v v v 
v v v v v v v v v v w f w f w f f f f f w f w f w v v v v v v v v v v v v v v v 
v v v v v v v v v v w f w f w f w w w f w e w f w v v v v v v v v v v v v v v v 
v v v v v v v v v v w f w f w f f f w f w w w f w w w w w w w w w v v v v v v v 
v v v v v v v v v v w f w f w f w f w f w f h f w w w w w f f f w w v v v v v v 
v v v v v v v v v v w f w f f f w f w p w f w f w w w f f f b f d w v v v v v v 
v v v v v v v v v v w f w w w f w f w w w f w f w w w f w f f f w w v v v v v v 
v v v v v v v v v v w f w f f f w f f f f f w f w w w f w w w w w v v v v v v v 
v v v v v v v v v v w f w f w f w w w w w w w f w w w f w v v v v v v v v v v v 
v v v v v v v v v v w f w f w f f f f f f f f f w w w f w v v v v v v v v v v v 
v v v v v v v v v v w f w f w w w w w w w f w w w w w f w v v v v v v v v v v v 
v v v v v v v v v v w f w e f f f f f h w f f f f e f f w v v v v v v v v v v v 
v v v v v v v v v v w f w w w w w w w f w w w w w w w f w v v v v v v v v v v v 
v v v v v v v v v v w f f f f f f f f f f f f f f f f f w v v v v v v v v v v v 
v v v v v v v v v v w w w w w w w w w w w w w w w w w w w v v v v v v v v v v v 
v v v v v v v v v v v v v v v v v v v v v v v v v v v v v v v v v v v v v v v v 
v v v v v v v v v v v v v v v v v v v v v v v v v v v v v v v v v v v v v v v v 
76