w w w w w w w w w w w w w w w w w w w w w w w w w w w w w w w w w w w w w w w w 
w f f f f f f f f h f h w w w w w w w w w w w w w w w w w w w w w w w w w w w w 
w f w w w w w w w f w f w w h f f w w h f f f f f f f f f f f f f f f f f h w w 
w f w p w w w h w f w f w w w w f w w f w w w w w w f w w w w w w w w w w f w w 
w f w f w w w f w f w e w f f f e f f f f f f h w w f w f f f w w w w w w f w w 
w f f f w w w f w f w f f f w w f w w w w w w f w w f w f b f f f f w w w f w w 
w w w f w w w f w f w w w w w w f w w h w w f f f w h w f f f w w f w w w f w w 
w h f e f f w f w f w w h w w w f f f f w w f b f w w w w f w w w f w w w f w w 
w f w w w f w f w f w w f w w w f w w w w w f f f w w w w f w w w f w w w f w w 
w f f f w f w f w f w w f w w w f w f f f w w f w w w w w f w w w f w w w f w w 
w f w f w f w f w f w w h f f f f w f b f f f f w w f f f f w w w f w w w e w w 
w f w f w f w h w f w w w w w w f w f f f w w w w w f w w w w w w f w w w f w w 
w f w f w f w f w f w h f e w w f w w f w w w w w w f w w w w w w f w w w f w w 
w f w h w f w f w f w w w f f f f w w f w w w w w f f f w w w w f f f w w f w w 
w f w f w f w e w f f f w w w w f w w f f f f f f f b f w w w w f b f d w f w w 
w f w f w f w f w f w f w f f f f w w w w w w w w f f f w w w w f f f w w f w w 
w f w f w f w f w f w h w f w w f w w w w w w w w w w w w w w w w w w w w f w w 
w f w f f h w f f f w w w f h w h f f f f f f f h f f f f f f f w w w w w f w w 
w f w w w f w w w f w w w w w w f w w w w w w w w w w w w w w f f f f f f h w w 
w e f f f f f f f h f f f f f f e f f f f f f f f f f f f f f h w w w w w w w w 
w w w w w w w w w w w w w w w w w w w w w w w w w w w w w w w w w w w w w w w w 
w w w w w w w w w w w w w w w w w w w w w w w w w w w w w w w w w w w w w w w w 
10