v v v v v v v v v v v v v v v v v v v v v v v v v v v v v v v v v v v v v v v v 
v v v v v v v v v v v v v v v v v v v v v v v v v v v v v v v v v v v v v v v v 
v v v v v v v v v v v v v v v v v v v v v v v v v v v v v v v v v v v v v v v v 
v v v v v v v v v v v v v v v v v v v v v v v v v v v v v v v v v v v v v v v v 
v v v v v v v v v v v v v v v v v v v v v v v v v v v v v v v v v v v v v v v v 
v v v v v v v v v v v v v v v v v w w w v v v v v v v v v v v v v v v v v v v v 
v v v v v v v v v v v v v v v v v w h w v v v v v v v v v v v v v v v v v v v v 
v v v v v v v v v v v v v v v v w w f w w v v v v v v v v v v v v v v v v v v v 
v v v v v v v v v v v v v v v v w f f f w w w w v v v v v v v v v v v v v v v v 
v v v v v v v v v v v v v v v v w f b f f f f w v v v v v v v v v v v v v v v v 
v v v v v v v v v v v v v v v v w f f f w w f w w v v v v v v v v v v v v v v v 
v v v v v v v v v v v v v w w w w w w w w f f f w w v v v v v v v v v v v v v v 
v v v v v v v v v v v v v w f p f f f f f f b f d w v v v v v v v v v v v v v v 
v v v v v v v v v v v v v w w w w w w w w f f f w w v v v v v v v v v v v v v v 
v v v v v v v v v v v v v v v v v v v v w w w w w v v v v v v v v v v v v v v v 
v v v v v v v v v v v v v v v v v v v v v v v v v v v v v v v v v v v v v v v v 
v v v v v v v v v v v v v v v v v v v v v v v v v v v v v v v v v v v v v v v v 
v v v v v v v v v v v v v v v v v v v v v v v v v v v v v v v v v v v v v v v v 
v v v v v v v v v v v v v v v v v v v v v v v v v v v v v v v v v v v v v v v v 
v v v v v v v v v v v v v v v v v v v v v v v v v v v v v v v v v v v v v v v v 
v v v v v v v v v v v v v v v v v v v v v v v v v v v v v v v v v v v v v v v v 
v v v v v v v v v v v v v v v v v v v v v v v v v v v v v v v v v v v v v v v v 
35