v v v v v v v v v v v v v v v v v v v v v v v v v v v v v v v v v v v v v v v v 
v v v v v v v v v v v v v v v v v v v v v v v v v v v v v v v v v v v v v v v v 
v v v v v v v v v v v v v v v v v v v v v v v v v v v v v v v v v v v v v v v v 
v v v v v v v v v v v v v v v v w w w v v v v v v v v v v v v v v v v v v v v v 
v v v v v v v v v v v v v v v v w h w w w w w w v v v v v v v v v v v v v v v v 
v v v v v v v v v v v v v w w w w f w w f f f w v v v v v v v v v v v v v v v v 
v v v v v v v v v v v v v w h f f e f f f b f w v v v v v v v v v v v v v v v v 
v v v v v v v v v v v v v w w f w w w w f f f w v v v v v v v v v v v v v v v v 
v v v v v v v v v v v v v v w f w w w w w f w w v v v v v v v v v v v v v v v v 
v v v v v v v v v v v v v v w f w w w w w f w w w v v v v v v v v v v v v v v v 
v v v v v v v v v v v v v v w f p f f f f f f f w v v v v v v v v v v v v v v v 
v v v v v v v v v v v v v v w w w w w w w w w f w w v v v v v v v v v v v v v v 
v v v v v v v v v v v v v v v v v v v w w w f f f w v v v v v v v v v v v v v v 
v v v v v v v v v v v v v v v v v v v w h f f b f w v v v v v v v v v v v v v v 
v v v v v v v v v v v v v v v v v v v w w w f f f w v v v v v v v v v v v v v v 
v v v v v v v v v v v v v v v v v v v v v w w d w w v v v v v v v v v v v v v v 
v v v v v v v v v v v v v v v v v v v v v v w w w v v v v v v v v v v v v v v v 
v v v v v v v v v v v v v v v v v v v v v v v v v v v v v v v v v v v v v v v v 
v v v v v v v v v v v v v v v v v v v v v v v v v v v v v v v v v v v v v v v v 
v v v v v v v v v v v v v v v v v v v v v v v v v v v v v v v v v v v v v v v v 
v v v v v v v v v v v v v v v v v v v v v v v v v v v v v v v v v v v v v v v v 
v v v v v v v v v v v v v v v v v v v v v v v v v v v v v v v v v v v v v v v v 
10