v v v v v v v v v v v v v v v v v v v v v v v v v v v v v v v v v v v v v v v v 
v v v v v v v v v v v v v v v v v v v v v v v v v v v v v v v v v v v v v v v v 
v v v v v v v v v v v v v v v v v v v v v v v v v v v v v v v v v v v v v v v v 
v v v v v v v v v v v v v v v v v v w w w v v v v v v v v v v v v v v v v v v v 
v v v v v v v v v v v v v v v v v v w h w v v v v v v v v v v v v v v v v v v v 
v v v v v v v v v v v v v v v v v w w e w w v v v v v v v v v v v v v v v v v v 
v v v v v v v v v v v v v v v w w w f f f w w w v v v v v v v v v v v v v v v v 
v v v v v v v v v v v v v v v w f f f b f f f w v v v v v v v v v v v v v v v v 
v v v v v v v v v v v v v v w w f w f f f w f w w v v v v v v v v v v v v v v v 
v v v v v v v v v v v v v w w f f f w w w f f f w w v v v v v v v v v v v v v v 
v v v v v v v v v v v v v w h f b f w p w f b f h w v v v v v v v v v v v v v v 
v v v v v v v v v v v v v w w f f f w f w f f f w w v v v v v v v v v v v v v v 
v v v v v v v v v v v v v v w w f w w f w w f w w v v v v v v v v v v v v v v v 
v v v v v v v v v v v v v v v w f w w f w w f w v v v v v v v v v v v v v v v v 
v v v v v v v v v v v v v v v w f f f f f f f w v v v v v v v v v v v v v v v v 
v v v v v v v v v v v v v v v w w w w d w w w w v v v v v v v v v v v v v v v v 
v v v v v v v v v v v v v v v v v v w w w v v v v v v v v v v v v v v v v v v v 
v v v v v v v v v v v v v v v v v v v v v v v v v v v v v v v v v v v v v v v v 
v v v v v v v v v v v v v v v v v v v v v v v v v v v v v v v v v v v v v v v v 
v v v v v v v v v v v v v v v v v v v v v v v v v v v v v v v v v v v v v v v v 
v v v v v v v v v v v v v v v v v v v v v v v v v v v v v v v v v v v v v v v v 
v v v v v v v v v v v v v v v v v v v v v v v v v v v v v v v v v v v v v v v v 
40